8,6,0,6,4,6,7
..,..,..,..,..,..,..,..
..,..,m.,m.,m.,m.,m.,m.
..,..,m.,.6,.9,.6,.6,.6
..,..,m.,.r,..,..,..,..
..,m-,.-,..,..,..,..,..
.g,..,..,..,..,..,..,..
