6,6,1,6,3,4,1
..,..,..,..,.g,..
m.,m-,m\,..,..,..
..,m.,m|,..,..,..
..,..,m|,..,..,..
..,..,m|,..,..,..
..,..,m|,..,..,..
